
    [ 
    [
        
        [1,1,1,1,1,1,1,1,1,1,1,1,1,1,1,1,1,1,1,1],
        [1,0,0,0,0,0,0,0,0,0,0,0,0,0,0,0,0,0,0,1],
        [1,0,0,0,0,0,0,6,0,0,0,0,0,0,0,0,0,0,5,1],
        [1,0,0,0,0,0,1,1,1,0,0,1,0,0,1,1,1,1,1,1],
        [1,0,0,0,0,0,0,0,0,0,0,0,0,0,0,0,0,0,0,1],
        [1,3,0,0,0,0,0,0,0,0,0,6,0,0,0,0,0,0,0,1],
        [1,1,1,0,0,0,0,0,0,0,0,0,0,0,0,0,1,0,0,1],
        [1,0,0,0,0,0,0,0,0,0,0,0,0,0,0,0,1,6,6,1],
        [1,0,0,0,0,0,1,1,0,0,0,0,0,0,0,1,1,1,1,1],
        [1,0,0,0,0,0,0,0,0,0,0,0,0,0,0,0,0,0,0,1],
        [1,6,0,4,0,0,4,0,0,0,0,0,0,0,0,0,0,0,0,1],
        [1,1,1,1,1,1,1,1,1,0,0,0,6,0,0,0,0,0,0,1],
        [1,0,0,0,0,0,0,0,0,0,0,0,1,0,0,0,0,6,3,1],
        [1,0,0,0,0,0,0,0,0,0,0,0,0,0,0,0,0,1,1,1],
        [1,0,0,0,0,0,0,0,0,0,0,0,0,0,0,0,0,0,0,1],
        [1,0,0,0,0,0,0,0,0,0,0,0,0,6,0,0,0,0,0,1],
        [1,0,0,0,0,0,0,6,0,0,0,0,1,1,1,0,0,0,0,1],
        [1,1,1,1,1,1,1,1,1,0,0,0,0,0,0,0,0,0,0,1],
        [2,2,2,2,2,2,2,2,2,3,3,3,3,3,3,3,3,3,3,1],
        [2,2,2,2,2,2,2,2,2,1,1,1,1,1,1,1,1,1,1,1]

    ],[
        
        [7,7,7,7,7,7,7,7,7,7,7,7,7,7,7,7,7,7,7,7],
        [7,0,0,0,0,0,0,0,0,0,0,0,0,0,0,0,0,0,0,7],
        [7,0,0,0,0,0,0,0,0,0,0,0,0,0,0,0,0,0,0,7],
        [7,6,0,0,0,0,0,0,0,0,0,0,0,0,0,0,0,0,9,7],
        [7,7,0,0,0,0,0,0,0,0,0,0,6,0,0,0,7,7,7,7],
        [7,0,0,0,0,0,6,0,0,0,0,0,7,0,0,0,0,0,0,7],
        [7,0,0,0,0,0,7,0,0,0,0,0,0,0,0,0,0,0,0,7],
        [7,0,0,0,0,0,0,0,0,0,0,0,0,0,0,0,0,0,0,7],
        [7,0,0,4,6,0,4,0,6,4,0,0,0,0,0,0,0,0,8,7],
        [7,7,7,7,7,7,7,7,7,7,7,7,0,0,0,0,7,7,7,7],
        [7,0,0,0,0,0,0,0,0,0,0,0,0,0,0,0,0,0,0,7],
        [7,0,0,0,0,0,0,6,0,0,0,0,0,6,0,0,0,0,8,7],
        [7,0,0,0,0,0,0,7,0,0,0,0,0,7,0,0,7,7,7,7],
        [7,0,0,0,0,0,0,0,0,0,0,0,0,0,0,0,0,0,0,7],
        [7,0,0,0,6,0,0,0,0,0,6,0,0,0,0,0,0,0,8,7],
        [7,0,0,0,7,0,0,0,0,0,7,0,0,0,0,0,7,7,7,7],
        [7,0,0,0,0,0,0,0,0,0,0,0,0,0,0,0,0,0,0,7],
        [7,0,0,0,0,0,0,0,0,0,0,0,0,0,0,0,0,0,0,7],
        [7,3,3,3,3,7,7,7,7,7,3,3,3,3,3,3,3,3,3,7],
        [7,7,7,7,7,7,7,7,7,7,7,7,7,7,7,7,7,7,7,7]

    ],[

        [10,10,10,10,10,10,10,10,10,10,10,10,10,10,10,10,10,10,10,10],
        [10,0,0,0,0,0,0,0,11,0,0,0,0,0,0,0,0,0,0,10],
        [10,0,0,0,0,0,0,0,0,0,0,0,0,0,0,0,0,0,5,10],
        [10,0,0,0,0,0,0,0,0,0,0,0,6,0,0,0,10,10,10,10],
        [10,0,0,0,0,0,0,12,0,0,0,0,10,0,0,0,0,0,0,10],
        [10,6,0,0,0,0,0,10,0,0,0,0,0,0,0,0,0,0,0,10],
        [10,10,0,0,0,0,0,0,0,0,0,0,0,0,0,6,0,0,0,10],
        [10,0,0,0,0,0,0,0,0,0,0,6,0,0,0,10,0,0,0,10],
        [10,0,0,0,0,0,6,0,0,0,0,10,0,0,0,0,0,0,6,10],
        [10,6,0,0,0,0,10,0,0,0,0,0,0,0,0,0,0,0,10,10],
        [10,10,0,0,0,0,0,0,0,6,0,0,0,0,6,0,0,0,0,10],
        [10,0,0,0,6,0,0,0,0,10,0,0,0,0,10,0,0,0,0,10],
        [10,0,0,0,10,0,0,0,0,0,0,0,0,0,0,0,0,0,0,10],
        [10,0,0,0,0,0,0,6,0,0,0,0,0,0,0,6,0,0,0,10],
        [10,6,0,0,0,0,0,10,0,0,0,0,0,0,0,10,0,0,0,10],
        [10,10,0,0,0,0,0,0,0,0,0,0,0,0,0,0,0,0,0,10],
        [10,0,0,0,0,0,0,0,0,0,0,0,0,0,0,0,0,13,0,10],
        [10,0,0,0,0,0,0,0,0,0,0,0,0,0,0,0,0,0,0,10],
        [10,0,0,0,0,0,0,0,0,0,0,0,0,0,0,0,0,0,0,10],
        [10,10,10,10,10,10,10,10,10,10,10,10,10,10,10,10,10,10,10,10]
    ]
]
